S#E          
 #####  # ###
 #####       
       ###   
### #  ###  #
  # #  ###   
  #          #
  # #  ###   #